w,w,w,w,w,w,w,w,w,w
w,,,,,k2,w,,w,w
w,,w,w,w,,w,,k1,w
w,,,w,,,d1,,w,w
w,,t,d2,,w,w,,w,w
w,d3,w,w,w,w,w,,w,w
w,p,,a,w,,,,w,w
w,,w,w,w,w,,w,w,w
w,,w,,c,w,,w,m,w
w,,w,,,w,,w,,w
w,,,,,t,k3,,,w
w,w,w,w,w,w,w,w,w,w
